NO images/wall.xpm
SO images/wall.xpm
WE images/wall.xpm
EA images/wall.xpm

F 0,0,0
C 0,100,225

1111111111111111111111111
1000000000110000000000001
1011000001110000000000001
100100000002000000000000111111111
111111111011000001110000000000001
100000000011000001112111111111111
11110111111111111100000020001
11110111111111411101010010001
11000000110101011100000010001
10000000000000001100000010001
11000000000000001101010010001
11000001110101011111011110E0111
11110111 1110101 101111010001 
11111111 1111111 111111111111
