1111111111
1000100001
100020X001
1000100001
1121112111
1000100001
1000100001
1000100001
100020N001
1111111111
