NO images/wall.xpm
SO images/wall.xpm
WE images/wall.xpm
EA images/wall.xpm

F 220,100,0
C 225,30,0

1111111111111111111111111
100000000011X0X0X0X0X0X01
1011000001110000000000001
10010000000200X0X0X0X0X0111111111
111111111011000001110000000000001
100000000011000001112111111111111
11110111111111111100000020001
11110111111111411101010010001
11000000110101011100000010001
10000000000000001100000010001
10000000000000001101010010001
11000001110101011111011110E0111
11110111 1110101 101111010001 
11111111 1111111 111111111111
