1111111111
1000100001
1000200001
1000100001
1121112111
1000100001
1000100001
1000100001
100020W001
1111111111
