1111111111
10001X00X1
1000200001
10001X00X1
1121112111
1000100001
1000100001
1000100001
100020N001
1111111111
