




11111111111
110001X00X1
1100020XX01
110001X00X1
11121112111
11000100001
11110100001
14000100001
1101010N001
11111111111

