1111111
1001001
1100011
1000001
1000001
1000001
1000001
1000001
1111111
