1111111111
1000100001
1000000001
1000100001
1101110001
1000110001
1000100001
1000100001
1000000001
1111111111
